43 36
0 0 0 0 0 0 0 0 0 0 0 0 0 0 0 0 0 0 0 0 0 0 0 0 0 0 0 0 0 0 0 0 0 0 0 0 0 0 0 0 0 0 0
0 0 0 0 0 0 0 0 0 0 0 0 0 0 0 0 0 0 0 0 0 0 0 0 0 0 0 0 0 0 0 0 0 0 0 0 0 0 0 0 0 0 0
0 0 0 0 0 0 0 0 0 0 0 0 0 0 0 0 0 0 0 0 0 0 0 0 0 0 0 0 0 0 0 0 0 0 0 0 0 0 0 0 0 0 0
0 0 0 0 0 0 0 0 0 0 0 0 0 0 0 0 0 0 0 0 0 0 0 0 0 0 0 0 0 0 0 0 0 0 0 0 0 0 0 0 0 0 0
0 0 0 0 0 0 0 0 0 0 0 0 0 0 0 0 0 0 0 0 0 0 0 0 0 0 0 0 0 0 0 0 0 0 0 0 0 0 0 0 0 0 0
0 0 0 0 0 0 0 0 0 0 0 0 0 0 0 0 0 0 0 0 0 0 0 0 0 0 0 0 0 0 0 0 0 0 0 0 0 0 0 0 0 0 0
0 0 0 0 0 0 0 0 0 0 0 0 0 0 0 0 0 0 0 0 0 0 0 0 0 0 0 0 0 0 0 0 0 0 0 0 0 0 0 0 0 0 0
0 6 0 0 0 0 0 0 0 6 6 6 6 6 6 6 6 6 6 6 6 6 6 6 6 6 6 6 6 6 6 6 6 6 6 6 6 6 6 6 6 6 6
0 6 0 0 0 0 0 0 0 6 1 0 0 0 0 0 0 0 0 0 0 0 0 0 0 0 0 0 0 0 6 0 6 0 0 6 0 0 0 0 0 0 6
0 6 0 0 0 0 0 0 0 0 1 0 0 0 0 0 0 0 0 0 0 0 0 0 0 0 0 0 0 0 6 0 6 0 0 6 0 0 0 0 0 0 6
0 6 0 0 0 0 0 0 0 6 1 0 0 0 0 0 0 0 0 0 0 0 0 0 0 0 0 0 0 0 6 0 6 0 0 6 0 0 0 0 0 0 6
0 6 0 0 0 0 0 0 0 6 1 0 0 0 0 0 0 0 0 0 0 0 0 0 0 0 0 0 0 0 6 0 6 0 0 6 0 0 0 0 0 0 6
0 6 0 0 0 0 0 0 0 6 1 0 0 0 0 0 0 0 0 0 0 0 0 0 0 0 0 0 0 0 6 0 6 0 0 6 0 0 0 0 0 0 6
0 6 0 0 0 0 0 0 0 6 1 0 0 0 0 0 0 0 0 0 0 0 0 0 0 0 0 0 0 0 6 0 6 0 0 6 0 0 0 0 0 0 6
0 6 0 0 0 0 0 0 0 6 1 1 1 1 1 1 1 1 1 1 1 1 1 1 1 1 1 0 6 0 6 0 6 0 0 6 0 0 0 0 0 0 6
0 6 0 0 0 0 0 0 0 6 0 0 0 0 0 0 0 0 0 1 0 0 0 0 0 0 1 0 0 0 6 0 6 0 0 6 0 0 0 0 0 0 6
0 6 0 0 0 0 0 0 0 6 0 6 0 6 0 6 0 6 0 1 0 0 0 0 0 0 1 0 6 0 6 0 6 0 0 6 0 0 0 0 0 0 6
0 6 0 0 0 0 0 0 0 6 0 0 0 0 0 0 0 0 0 1 0 0 0 0 0 0 1 0 0 0 6 0 6 0 0 6 0 0 0 0 0 0 6
0 6 0 0 0 0 0 0 0 6 0 6 0 6 0 6 0 6 0 1 0 0 0 0 0 0 1 0 6 0 6 0 6 0 0 6 0 0 0 0 0 0 6
0 6 0 0 0 0 0 0 0 6 0 0 0 0 0 0 0 0 0 1 0 0 0 0 0 0 1 0 0 0 6 0 6 0 0 6 0 0 0 0 0 0 6
0 6 0 0 0 0 0 0 0 6 0 6 0 6 0 6 0 6 0 1 7 4 7 7 5 7 1 0 6 0 6 0 6 0 0 6 0 0 0 0 0 0 6
0 6 0 0 0 0 0 0 0 6 0 0 0 0 0 0 0 0 0 1 7 2 7 7 2 7 1 0 0 0 6 0 6 0 0 6 0 0 0 0 0 0 6
0 6 0 0 0 0 0 0 0 6 0 6 0 6 0 6 0 6 0 1 1 1 1 1 1 1 1 0 6 0 6 0 6 0 0 6 0 0 0 0 0 0 6
0 6 0 0 0 0 0 0 0 6 0 0 0 0 0 0 0 0 0 0 0 0 0 0 0 0 1 0 0 0 6 0 6 0 0 6 0 0 0 0 0 0 6
0 6 0 0 0 0 0 0 0 6 0 6 0 6 0 6 0 6 0 0 0 0 0 0 0 0 1 0 0 0 6 0 6 0 0 6 0 0 0 0 0 0 6
0 6 0 0 0 0 0 0 0 6 0 0 0 0 0 0 0 0 0 0 0 0 0 0 0 0 1 9 9 9 6 0 6 0 0 6 0 0 0 0 0 0 6
0 6 0 0 0 0 0 0 0 6 0 6 0 6 0 6 0 6 0 0 0 0 0 0 0 0 1 8 8 8 6 0 6 0 0 6 0 0 0 0 0 0 6
0 6 0 0 0 0 0 0 0 6 0 0 0 0 0 0 0 0 0 0 0 0 0 0 0 0 1 3 8 8 6 0 6 0 0 6 0 0 0 0 0 0 6
0 6 6 6 6 6 6 6 6 6 6 6 0 6 6 6 6 6 6 6 6 6 6 6 6 6 6 6 6 6 6 6 6 6 6 6 6 6 6 6 6 6 6
0 0 0 0 0 0 0 0 0 0 0 0 0 0 0 0 0 0 0 0 0 0 0 0 0 0 0 0 0 0 0 0 0 0 0 0 0 0 0 0 0 0 0
0 0 0 0 0 0 0 0 0 0 0 0 0 0 0 0 0 0 0 0 0 0 0 0 0 0 0 0 0 0 0 0 0 0 0 0 0 0 0 0 0 0 0
0 0 0 0 0 0 0 0 0 0 0 0 0 0 0 0 0 0 0 0 0 0 0 0 0 0 0 0 0 0 0 0 0 0 0 0 0 0 0 0 0 0 0
0 0 0 0 0 0 0 0 0 0 0 0 0 0 0 0 0 0 0 0 0 0 0 0 0 0 0 0 0 0 0 0 0 0 0 0 0 0 0 0 0 0 0
0 0 0 0 0 0 0 0 0 0 0 0 0 0 0 0 0 0 0 0 0 0 0 0 0 0 0 0 0 0 0 0 0 0 0 0 0 0 0 0 0 0 0
0 0 0 0 0 0 0 0 0 0 0 0 0 0 0 0 0 0 0 0 0 0 0 0 0 0 0 0 0 0 0 0 0 0 0 0 0 0 0 0 0 0 0
0 0 0 0 0 0 0 0 0 0 0 0 0 0 0 0 0 0 0 0 0 0 0 0 0 0 0 0 0 0 0 0 0 0 0 0 0 0 0 0 0 0 0