5 7
0 0
0 0 0 0 0
1 1 1 1 1
0 0 0 0 0
0 0 2 2 3
0 4 5 3 0
0 0 0 3 0
0 1 0 2 0